{
    "tileData": {
        "atlas": "map.png",
        "positions": [
            [0,0,16,16], 
            [16,0,16,16],
            [32,0,16,16],
            [48,0,16,16],
            [32,16,16,16],
            [48,16,16,16],
            [32,32,16,16],
            [48,32,16,16]
        ]
    },
    "layerData": {
        "dimensions": [16,16],
        "layers": [
            [   
                [0,0,0,0,0,0,0,0,0,0,0,0,6,6,0,0],
                [0,0,0,0,0,0,0,0,0,0,0,0,6,6,0,0],
                [0,0,0,0,0,0,0,0,0,0,0,0,6,6,0,0],
                [2,2,2,2,4,4,2,2,2,2,2,2,4,4,0,0],
                [2,2,2,2,4,4,2,2,2,2,2,2,4,4,0,0],
                [0,0,0,0,6,6,0,0,0,0,0,0,6,6,0,0],
                [0,0,0,0,6,6,0,1,1,1,1,0,6,6,0,0],
                [0,0,0,0,6,6,0,1,1,1,1,0,6,6,0,0],
                [0,0,0,0,6,6,0,1,1,1,1,0,6,6,0,0],
                [0,0,0,0,6,6,0,1,1,1,1,0,6,6,0,0],
                [0,0,0,0,6,6,0,0,1,1,0,0,6,6,0,0],
                [0,0,0,0,6,6,0,0,1,1,0,0,6,6,0,0],
                [2,2,2,2,4,4,2,2,2,2,2,2,4,4,0,0],
                [2,2,2,2,4,4,2,2,2,2,2,2,4,4,0,0],
                [0,0,0,0,0,0,0,0,0,0,0,0,0,0,0,0],
                [0,0,0,0,0,0,0,0,0,0,0,0,0,0,0,0]
            ]
        ]
    }
}